(supertux-level
  (version 3)
  (name (_ "Level 2"))
  (author "SuperTux Player")
  (license "CC-BY-SA 4.0 International")
  (icon "")
  (icon-locked "")
  (sector
    (name "main")
    (ambient-light
      (color 1 1 1)
    )
    (camera
      (name "Camera")
      (mode "normal")
    )
    (music
    )
    (path
      (name "gen170688945894855512797632")
      (path
        (mode "oneshot")
        (adapt_speed #f)
        (node
          (x 64)
          (y 544)
        )
      )
    )
    (spawnpoint
      (name "main")
      (x 64)
      (y 480)
    )
    (tilemap
      (handle
        (scale_x 0)
        (scale_y 0)
        (offset_x 0)
        (offset_y 0)
      )
      (solid #t)
      (z-pos 0)
      (path-ref "gen170688945894855512797632")
      (width 1)
      (height 1)
      (tiles
      1
      )
    )
  )
)
